1111111111111111111111111111111111111111111111111111111111111111111111111111111111111111111111111111
1000011111111111111110000000000000000000000000000000000222000000000000000000000000000000000000000001
1008001111111111100000000000000000000000000000000000022333302220000000000000000000011111111200000001
1100000111111111000000000000000000001111111110000002233333333333320000000004000000010000001220202001
1100000001111110000000000000000000001000000010000000222444444433332200000044400000010000009000002201
1100000001111000000000111111111000001000@00010000000223333344433332000000004300000010000001222002201
11100000111000000000001000000010000090000000100000000002222244222200000000000000000100-0001200004441
1111001110000000000000100000001000001005550010000000000002223332000002000000032000010000001000003341
1100000000000000000000100000001000001005550010000000022000002222000033300000222000011111111000333441
1000000000000000000000100000009000001111111110000000022220355555533333430000000000000000000000334441
1000000000000000000000100000001000000000000000000000222223333355344044443322000000000002000034444441
1000000000000000000000100000001000000000000000000000022233333333444444444332220000000332000333344441
1000000000000000000000100000001000000000000000000000000222333344444444444444433305555444220033334441
1000000000000000000000111111111000000111111100000000000222222333333344444444333335555022000334444441
1000000000000000000000000000000000000100000100000000000022223334444444444444443305555022222344444441
1000000000000000000000000000000000000100000100000000000000022233333344444444444320000022244444444441
1000000000000000000000111111119111111100000100000000000000022223334444444444444322000222223344444441
1000000000000000000000100000000000000100000100000000000022223333333334444444433200002223333444444441
1000000000000000000000100000000000000100000100000000000002233334444444444444333220002222334444444441
1000000000000000000000100000000000000100000100000000000000002333333444444444322000000222233344444441
1000000000000000000000100000000000000100000100000000000000022222333334444443322200000002223333444441
1000000000000000000000100000000000000900000100000000000000000222223333344433222555555222233444444441
1000000000000000000000111111111111111111111100000000000000000002223333333333225555522222223334444441
1000000000000000000000000000000000000000000000000000000000000000022333333332200000000222334444444331
1000000000000000000000000000000000000000000000000000000000000000002222223322220000222223444444443331
1000000000000000000000111111111111911111111110000000000000000000000002222222200000002222334444444331
1000000000000000000000100000001000000000000010000000000000000000000000022220000000002344444444433331
1000000000000000000000100000001000000000000010000000000000000000000000002200000000000022333444443331
1000000000000000000000100000009000000000000010000000000000000000000000000000000000002223334444444331
1000000000000000000000100000001000000000000010000000000000000000000000000000000000000022222334444431
1w00000000000000000000100000001000000000000010000000000000000000000000000000000000002222344444443331
1www000000000000000000100000001000000000000010000000000000000000000000000000000000222222233334444441
1wwww00000000000000000111111111111111111111110000000000000000000000000000000000000000002222333344441
1wwwwww000000000000000000000000000000000000000000000000000000000000000000000000000000000022222333441
1wwwwwwwww000000000000000000000000000000000000000000000000000000000000000000000000000000000222223331
10wwwwwwwww00000000000000000000000000000000000000000000000000000000000000000000000000000000002222221
1000wwwwwwwwww00000000000000000000000000000000000000000000000000000000000000000000000000000000000221
100000wwwwwwwwwwwwww00000000000000000000000000000000000000000000000000000000000000000000000000002221
10000000wwwwwwwwwwwwwwww0000000000000000000000000000000000000000000000000000000000000000000000000021
1000000000wwwwwwwwwwwwwwwwwwww00000000000000000000000000wwwwwww0000000000000000000000000000000000001
1000000000000wwwwwwwwwwwwwwwwwwwwwwwwww00000000wwwwwwwwwwwwwwwwwww0000000000000000000000000000000001
10000000000000000000wwwwwwwwwwwwwwwwwwwwwwwwwwwwwwwwwwwwwwwwwwwwwwwwwwwww000000000000000000000000001
1000000000000000000000000wwwwwwwwwwwwwwwwwwwwwwwwwwwwwwwwwwwwwwwwwwwwwwwwwwww00000000000000000000001
1000000000000000000000000000000wwwwwwwwwwwwwwwwwwwwwwwwwww0000wwwwwwwwwwwwwwwbbbb0000000000000000001
110000000000000000000000000000000000000wwwwwwwww00000000000000000000wwwwwwwwbbbbbwwwww00000000000001
110000000000000000000000000000000000000000000000000000000000000000000000wwwbbbbbwwwwwwww000000000001
1110000000000000000000000000000000000000000000000000000000000000000000000000bbbwwwwwwwwwwwwww0000001
1111100000000000000000000000000000000000000000000000006660000000000000000000000wwwwwwwwwwwwwwwwww001
11111111000000000000000000000000000000000000000000000066600000000000000000000000000wwwwwwwwwwwwwwww1
111111111111000111000000000000000000000000000000000000666000000000000000000000000000000wwwwwwwwwwww1
1000000000110001111000000000000000000000000000000000000000000000000000000000000000000000000wwwwwwww1
1000000000000000000111100000000000000000000000000000000000000000000000000000000000000000000000wwwww1
100000011110000000000111110000000000000000000000000000000000000000000000000000000000000000000000www1
10000111111111000000001111110000000000000000000000000000000000002222222222222222222222222220000000w1
1000001111111111000000000111110000000000000000000000002222222222222222222222222222222222222222220001
1000000011111110000666000111111000000000000022222222222222222222223322222222222222222222222222222221
1000000000111100000666600011111110022222222222222222222222333333344443333333333333222222222222222221
1000000001111100000666660000111111222222222222222223333333334444444444444333333333333333333333322221
1000000000011110000000000000001111222222222233333333334444444444444444444444444444433333333333333221
1000000000011111000000080000001111444444443334444444444444411111111111111114444444444444433333333331
1000000000000111111100000000011111444444444444444411111111114444444444444411111111114444444444444441
1000000000000011111111000111111111444441111111111114444444444444444444444444444444411111144444444441
1000000000000000000011111111111111111111444444444444444443333333333333333334444444444444111111111111
1000000000000000000000000000001111111444444444444433333333333322222222333333333333334444444444444441
1000000000000000000000000000000011111111114443333333333222222222222222222223333333333333333344444441
1100000000006666600000000000001111000111111122222222222222222222222222222222222222223333333333333441
1110000000006666600000000000000111000000011111122222222222222222200022222222222222222222223333333331
1110000000006666600000000000000111100000000011112222222222200000000000000000022222222222222222333331
1111000000006666600000000000011111000000000001112220000000000000000000000000000022222222222222222221
1111000000006666600000000001111100000000000011111200000000000000000000000000000000000222222222222221
1111111000000000000000111111100000000080000000111100000000000000000000000000000000000000000000000001
11111111100000000001111111100000000066600000111110000000000000000-0000000000000000000000000000000001
1111111111000000011111111111100000006660000000111111000000000000000000000000000000000000000002000001
1111111000000000001111111111111100006666600000011111100000000000000000000000000000000000000222000001
1111000000000011111111111111111111000000000000000111100000000000000000022220000000000000000022200001
1110000000001111111110000001111111111110000000000111110000000000000222333332200000000000000000000001
1111000000000111110000000008000001111111000000011111100000000000022233344432222000000000000000000001
1110000000000001111100000066600000000111100000000111111100000000223334444422200000000000000000000001
1100000000000000011110000066600000111110000000000001111110000000002233333330000010000000000000000001
110000000000000000011100006660000011110000000000000011110000000000000222200000011100000000000-000001
1111000000000000000011111000000011111000000000000000011110000000000000000000001111100000000000000001
1111110000000000000000000000001111110000000000000000111111100000000000001100011000110001100000000001
1111111100000000000000000011111111000000000011111111111111000000000000011000110000011000110000000001
11111111110000000000000011110000000000001111111111111111111000000000000110000000x0000000110000000001
1111111110000555500000000000000000001111111000001111111111110000000000011000110000011000110000000001
1111111110000555500000000000000000011111110000000000111111110000000000001100011000110001100000000001
1111111000000555500000000000011111111100000000000000011111111100000000000000001111100000000000000001
1111100000000555500000000011111110000000000000000000001111111100000000000000000111000000000000000001
1111000000000000000001111111000000000000000000000000011111111110000000000000000010000000000000000001
1111000000000000000011111111100000000000777770000000000111111100000000000000000000000000000000000001
1111110000000000001111111100000000000000077770000000000011111000000000000000000000000002224330000001
1111111000000000000111111000000000000000007770000000000001111000000000000000-00000000022444400000001
1111100000000000000001110000000000000000000770000000000001110000000000000000000000000023344300000001
1100000000000000000000000000000000000000000770000000000000111000000000000000000000000000022000000001
1100000000000000011111110000000000000000000770000000000000001100000000000000000000000000000000000001
1100000000000001111111100000000000000000007770000000000000000=00000000000000000000000000000000000011
111000000000111111111000000000000000000007777000000000000001111000000000000000000000000000000-000011
1111000000000011111111000000000000000000777770000000000000111110000000000000000000000000000000000111
1111111000000000011111100000000000000000000000000000000001111111100000000000000000000000000000011111
1111111111111111111111111111111111111111111111111111111111111111111111111111111111111111111111111111